111111111111111111111111111111
1P0011000E10000000011000110111
1000110C0010000000011000101111
111111111111111111111111111111