111111111111111111111111111
100000000000000000000000001
100110010001100100000000001
101000101010001010000000001
101000111010001110000000001
100110101001101010000000001
100000000000000000000000001
100000000000000000000000001
100000000000000000000000001
100000000000000000000000001
100000000000000000000000001
100000000000000000000000001
100000000000000000000000001
100000000000000000000000001
100000000000000000000000001
100000000000000C00000000001
10000000000000C0C0000000001
100000000000000C00000000001
100000000000000000000000001
1PE0000000000000000000000C1
111111111111111111111111111