111111111111111111111
101000000010001000001
101010111110111010101
100010000000100010101
101011101110101111101
101010000010100010001
1011111010101C1010111
100010001010101010001
111111101010101111101
101010101010000000101
10101011111E111110101
101010100000001000101
101010111111111110101
100000001000001000101
101111111010111011111
100000100010100000001
111011101110101111111
100010001000100000101
101110101011101010101
100000101000001010P01
111111111111111111111